NO ./path_to_the_north_texture
SO ./path_to_the_south_texture
WE ./path_to_the_west_texture
EA ./path_to_the_east_texture
F 220,100,0
C 225,30,0


         11111111111111
11111111100000111111111
111000001110000N00000111
100100000000000000110101
111111011011000001 110001
1111111111111111111 111111
111
