NO ./Textures/wolftex/wood.xpm
SO ./Textures/wolftex/greystone.xpm
WE ./Textures/wolftex/redbrick.xpm
EA ./Textures/wolftex/bluestone.xpm
F 250,250, 250
C 225,30,0


111111111111111111111111
10000000001100000000000011111111
1011000001110000000000001
100100000000000000000000111
110000000000N0000000000001
1000000000000000000000001
1000000000000000000000001
1000000000000000000000001
11000000000000000000000001
1000000000000000000000001
1000000000000000000000001
11000000000000000000000001
1000000000000000000000001
1000000000000000000000001
100000000001000000010001111
1000000000000000000000001
1000000000000000000000001
1000000000000000000000001
100000000001000000010001111
100000000001000000010001111
111111111111111111111111111
1111111111111111111111111111
