NO ./Textures/green2.xpm
SO ./Textures/greystone.xpm
WE ./Textures/green2.xpm
EA ./Textures/greystone.xpm
F 200,200,200
C 225,30,0
111111
100001
100001
10N101
100001
111111

