NO ./Textures/wolftex/wood.xpm
SO ./Textures/wolftex/greystone.xpm
WE ./Textures/wolftex/redbrick.xpm
EA ./Textures/wolftex/bluestone.xpm
F 139,69,19
C 135,206,235


111111111111111111111111
10000000001100000000000011111111
1011000001100000000000001
100100000000000000000000111
11000000000N00000000000001
1000000000000000000000001
1000000000000000000000001
1000000000000000000000001
11000000000000000000000001
1000000000000000000000001
1000000000000000000000001
11000000000000000000000001
1000000000000000000000001
1000000000000000000000001
100000000001000000010001111
1000000000000000000000001
1000000000000000000000001
1000000000000000000000001
100000000001000000010001111
100000000001000000010001111
111111111111111111111111111
1111111111111111111111111111
