NO ./Textures/wolftex/copy.xpm
SO ./Textures/wolftex/copy.xpm
WE ./Textures/wolftex/copy.xpm
EA ./Textures/wolftex/copy.xpm
F 0,0,0
C 0,0,0
111111
101111
11W001
100011111
100001
111111
