NO ./Textures/wolftex/copy.xpm
SO ./Textures/wolftex/copy.xpm
WE ./Textures/wolftex/copy.xpm
EA ./Textures/wolftex/copy.xpm
F 0,0,0
C 0,0,0
111111111111
100000011101
101111010101
100001000101
111101011101
1E0001000011
111111111111