NO ./Textures/wolftex/wood.xpm
SO ./Textures/wolftex/greystone.xpm


WE ./Textures/wolftex/redbrick.xpm



EA ./Textures/wolftex/bluestone.xpm


F 186, 255, 201
C 255, 179, 186
        1111111111111111111111111
        1000000000110000000000001
        1011000001110000000000001
        10010000000000E0000000001
111111111011000001110000000000001
100000000011000001110111111111111
11110111111111011100000010001
11110111111111011101010010001
11000000110101011100000010001
10000000000000001100000010001
10000000001111111101010010001
1100000111	101010111110111111111
11110111 11111111101111010001
11111111 1111111 111111111111
